7 7 7 7 7 7 7 7 7 7 7 7 7 7 7 -1
7 7 7 7 7 7 7 7 7 7 7 7 7 7 7 -1
7 7 7 7 7 7 7 7 7 7 7 7 7 7 7 -1
7 7 7 7 7 7 7 7 7 7 7 7 7 7 7 -1
7 7 7 7 7 7 7 7 7 7 7 7 7 7 7 -1
7 7 7 7 7 7 7 7 7 7 7 7 7 7 7 -1
7 7 7 7 7 7 7 7 7 7 7 7 7 7 7 -1
7 7 7 7 7 7 7 7 7 7 7 7 7 7 7 -1
7 7 7 7 7 7 7 7 7 7 7 7 7 7 7 -1
7 7 7 7 7 7 7 7 7 7 7 7 7 7 7 -1
7 7 7 7 7 7 7 7 7 7 7 7 7 7 7 -1
7 7 7 7 7 7 7 7 7 7 7 7 7 7 7 -1
7 7 7 7 7 7 7 7 7 7 7 7 7 7 7 -1
7 7 7 7 7 7 7 7 7 7 7 7 7 7 7 -1
7 7 7 7 7 7 7 7 7 7 7 7 7 7 7 -1
-2
8 8 8 8 8 8 8 8 8 8 8 8 8 8 8 -1
8 8 8 8 8 8 8 8 8 8 8 8 8 8 8 -1
8 8 8 8 8 8 8 8 8 8 8 8 8 8 8 -1
8 8 8 8 8 8 8 8 8 8 8 8 8 8 8 -1
8 8 8 8 8 8 8 8 8 8 8 8 8 8 8 -1
8 8 8 8 8 8 8 8 8 8 8 8 8 8 8 -1
8 8 8 8 8 8 8 8 8 8 8 8 8 8 8 -1
8 8 8 8 8 8 8 8 8 8 8 8 8 8 8 -1
8 8 8 8 8 8 8 8 8 8 8 8 8 8 8 -1
8 8 8 8 8 8 8 8 8 8 8 8 8 8 8 -1
8 8 8 8 8 8 8 8 8 8 8 8 8 8 8 -1
8 8 8 8 8 8 8 8 8 8 8 8 8 8 8 -1
8 8 8 8 8 8 8 8 8 8 8 8 8 8 8 -1
8 8 8 8 8 8 8 8 8 8 8 8 8 8 8 -1
8 8 8 8 8 8 8 8 8 8 8 8 8 8 8 -1
-2
3 3 3 3 3 3 3 3 3 3 3 3 3 3 3 -1
3 3 3 3 3 3 28 24 29 3 3 3 3 3 3 -1
3 3 3 4 4 4 4 4 4 4 4 4 3 3 3 -1
3 3 3 6 6 6 6 4 6 6 6 6 3 3 3 -1
3 3 3 6 4 4 4 4 4 4 4 6 3 3 3 -1
3 3 3 6 4 4 4 4 4 4 4 6 3 3 3 -1
3 3 3 6 4 4 4 4 4 4 4 6 3 3 3 -1
3 3 3 6 4 4 4 4 4 4 9 6 3 3 3 -1
3 3 3 6 4 4 4 4 4 4 4 6 3 3 3 -1
3 3 3 6 4 4 4 4 4 4 4 6 3 3 3 -1
3 3 3 6 4 4 4 4 4 4 4 6 3 3 3 -1
3 3 3 6 6 6 6 6 6 6 6 6 3 3 3 -1
3 3 3 3 3 3 3 3 3 3 3 3 3 3 3 -1
3 3 3 3 3 3 3 3 3 3 3 3 3 3 3 -1
3 3 3 3 3 3 3 3 3 3 3 3 3 3 3 -1
-2
0 0 0 0 0 0 0 0 0 0 0 0 0 0 0 -1
0 0 0 0 0 0 0 0 0 0 0 0 0 0 0 -1
0 0 0 0 0 0 0 0 0 0 0 0 0 0 0 -1
0 0 0 6 6 6 6 0 6 6 6 6 0 0 0 -1
0 0 0 6 0 0 0 0 0 0 13 6 0 0 0 -1
0 0 0 6 0 0 0 0 0 0 12 6 0 0 0 -1
0 0 0 6 0 0 0 0 0 0 9 6 0 0 0 -1
0 0 0 6 0 0 0 0 0 0 10 6 0 0 0 -1
0 0 0 6 0 0 0 0 0 0 9 6 0 0 0 -1
0 0 0 6 0 0 0 0 0 0 11 6 0 0 0 -1
0 0 0 6 0 0 0 0 0 0 0 6 0 0 0 -1
0 0 0 6 6 6 6 6 6 6 6 6 0 0 0 -1
0 0 0 0 0 0 0 0 0 0 0 0 0 0 0 -1
0 0 0 0 0 0 0 0 0 0 0 0 0 0 0 -1
0 0 0 0 0 0 0 0 0 0 0 0 0 0 0 -1
-2
0 0 0 0 0 0 0 0 0 0 0 0 0 0 0 -1
0 0 0 0 0 0 0 0 0 0 0 0 0 0 0 -1
0 0 0 0 0 0 0 0 0 0 0 0 0 0 0 -1
0 0 0 6 6 1 6 0 6 1 6 6 0 0 0 -1
0 0 0 6 0 0 0 0 0 0 0 6 0 0 0 -1
0 0 0 6 0 0 0 0 0 0 0 6 0 0 0 -1
0 0 0 6 0 0 0 0 0 0 14 6 0 0 0 -1
0 0 0 6 0 0 0 0 0 0 9 6 0 0 0 -1
0 0 0 6 0 0 0 0 0 0 15 6 0 0 0 -1
0 0 0 6 0 0 0 0 0 0 0 6 0 0 0 -1
0 0 0 6 0 0 0 0 0 0 0 6 0 0 0 -1
0 0 0 6 6 6 6 6 6 6 6 6 0 0 0 -1
0 0 0 0 0 0 0 0 0 0 0 0 0 0 0 -1
0 0 0 0 0 0 0 0 0 0 0 0 0 0 0 -1
0 0 0 0 0 0 0 0 0 0 0 0 0 0 0 -1
-2
0 0 0 0 0 0 0 0 0 0 0 0 0 0 0 -1
0 0 0 0 0 0 0 0 0 0 0 0 0 0 0 -1
0 0 0 0 0 0 0 0 0 0 0 0 0 0 0 -1
0 0 0 6 6 6 6 6 6 6 6 6 0 0 0 -1
0 0 0 6 0 0 0 0 0 0 0 6 0 0 0 -1
0 0 0 6 0 0 0 0 0 0 0 6 0 0 0 -1
0 0 0 6 0 0 0 0 0 0 0 6 0 0 0 -1
0 0 0 6 0 0 0 0 0 0 9 6 0 0 0 -1
0 0 0 6 0 0 0 0 0 0 0 6 0 0 0 -1
0 0 0 6 0 0 0 0 0 0 0 6 0 0 0 -1
0 0 0 6 0 0 0 0 0 0 0 6 0 0 0 -1
0 0 0 6 6 6 6 6 6 6 6 6 0 0 0 -1
0 0 0 0 0 0 0 0 0 0 0 0 0 0 0 -1
0 0 0 0 0 0 0 0 0 0 0 0 0 0 0 -1
0 0 0 0 0 0 0 0 0 0 0 0 0 0 0 -1
-2
0 0 0 0 0 0 0 0 0 0 0 0 0 0 0 -1
0 0 0 0 0 0 0 0 0 0 0 0 0 0 0 -1
0 0 20 16 16 16 16 16 16 16 16 16 21 0 0 -1
0 0 19 6 6 6 6 6 6 6 6 6 17 0 0 -1
0 0 19 6 6 6 6 6 6 6 6 6 17 0 0 -1
0 0 19 6 6 6 6 6 6 6 6 6 17 0 0 -1
0 0 19 6 6 6 6 6 6 6 6 6 17 0 0 -1
0 0 19 6 6 6 6 6 6 6 6 6 17 0 0 -1
0 0 19 6 6 6 6 6 6 6 6 6 17 0 0 -1
0 0 19 6 6 6 6 6 6 6 6 6 17 0 0 -1
0 0 19 6 6 6 6 6 6 6 6 6 17 0 0 -1
0 0 19 6 6 6 6 6 6 6 6 6 17 0 0 -1
0 0 23 18 18 18 18 18 18 18 18 18 22 0 0 -1
0 0 0 0 0 0 0 0 0 0 0 0 0 0 0 -1
0 0 0 0 0 0 0 0 0 0 0 0 0 0 0 -1
-2
0 0 0 0 0 0 0 0 0 0 0 0 0 0 0 -1
0 0 0 0 0 0 0 0 0 0 0 0 0 0 0 -1
0 0 0 0 0 0 0 0 0 0 0 0 0 0 0 -1
0 0 0 20 16 16 16 16 16 16 16 21 0 0 -1
0 0 0 19 6 6 6 6 6 6 6 17 0 0 -1
0 0 0 19 6 6 6 6 6 6 6 17 0 0 -1
0 0 0 19 6 6 6 6 6 6 6 17 0 0 -1
0 0 0 19 6 6 6 6 6 6 9 17 0 0 -1
0 0 0 19 6 6 6 6 6 6 6 17 0 0 -1
0 0 0 19 6 6 6 6 6 6 6 17 0 0 -1
0 0 0 19 6 6 6 6 6 6 6 17 0 0 -1
0 0 0 23 18 18 18 18 18 18 18 22 0 0 -1
0 0 0 0 0 0 0 0 0 0 0 0 0 0 0 -1
0 0 0 0 0 0 0 0 0 0 0 0 0 0 0 -1
0 0 0 0 0 0 0 0 0 0 0 0 0 0 0 -1
-2
0 0 0 0 0 0 0 0 0 0 0 0 0 0 0 -1
0 0 0 0 0 0 0 0 0 0 0 0 0 0 0 -1
0 0 0 0 0 0 0 0 0 0 0 0 0 0 0 -1
0 0 0 0 0 0 0 0 0 0 0 0 0 0 0 -1
0 0 0 0 0 0 0 0 0 0 0 0 0 0 0 -1
0 0 0 0 0 0 0 0 0 0 0 0 0 0 0 -1
0 0 0 0 0 0 0 0 0 0 0 0 0 0 0 -1
0 0 0 0 0 0 0 0 0 0 9 0 0 0 0 -1
0 0 0 0 0 0 0 0 0 0 0 0 0 0 0 -1
0 0 0 0 0 0 0 0 0 0 0 0 0 0 0 -1
0 0 0 0 0 0 0 0 0 0 0 0 0 0 0 -1
0 0 0 0 0 0 0 0 0 0 0 0 0 0 0 -1
0 0 0 0 0 0 0 0 0 0 0 0 0 0 0 -1
0 0 0 0 0 0 0 0 0 0 0 0 0 0 0 -1
0 0 0 0 0 0 0 0 0 0 0 0 0 0 0 -1
-2